############################################
#         .        .        .       .      #
#   . .    ..      ..          .           #
#  ##############      #####################
#   .         ..             .       ..    #
#        .           ...                   #
#    ###      ###################          #
#      #  .   #   . .    .            .    #
# .    #   .  #                .           #
#      #  .   ###################          #
#    ###            .     .                #
#          .            .        .         #
############################################